********************
*1---W-------------*
*------------------*
*------------W----->
*------------------*
*------------------*
*------------------*
*-----W------------*
*------------------*
*********V**********