********^***********
*3-----------------*
*---W--------------*
<------------------*
*------------------*
*------------------*
*---W--------------*
*------------------*
*------------------*
********************
