*****^**************
*4-----W-----------*
*------------------*
*------------------*
*----------W-------*
*---W-------------->
*------------------*
*A-------------O---*
*------------------*
********************
