********************
*1-----------------*
*------------------*
*------------------>
*------------------*
*------------------*
*------------------*
*------------------*
*------------------*
*********V**********