********************
*2-----------------*
*------------------*
<----W-------------*
*------------------*
*---------------W--*
*---W--------------*
*------------------*
*------------------*
*********V**********