********************
*2-----------------*
*------------------*
<------------------*
*------------------*
*------------------*
*------------------*
*------------------*
*------------------*
*********V**********