*****^**************
*4-----------------*
*------------------*
*------------------*
*------------------*
*------------------>
*------------------*
*A-------------O---*
*------------------*
********************